atgtcacatctcgcagaact	goodDNA_1
tgtcacatctcgcagaactg	goodDNA_1
gtcacatctcgcagaactgg	goodDNA_1
tcacatctcgcagaactggt	goodDNA_1
cacatctcgcagaactggtt	goodDNA_1
acatctcgcagaactggttg	goodDNA_1
catctcgcagaactggttgc	goodDNA_1
atctcgcagaactggttgcc	goodDNA_1
tctcgcagaactggttgcca	goodDNA_1
ctcgcagaactggttgccag	goodDNA_1
tcgcagaactggttgccagt	goodDNA_1
atgcttttttcatcgccaaa	goodDNA_2
tgcttttttcatcgccaaaa	goodDNA_2
gcttttttcatcgccaaaag	goodDNA_2
cttttttcatcgccaaaaga	goodDNA_2
ttttttcatcgccaaaagaa	goodDNA_2
tttttcatcgccaaaagaag	goodDNA_2
ttttcatcgccaaaagaagg	goodDNA_2
tttcatcgccaaaagaaggg	goodDNA_2
ttcatcgccaaaagaaggga	goodDNA_2
tcatcgccaaaagaagggaa	goodDNA_2
catcgccaaaagaagggaaa	goodDNA_2
